10 10 10 . 0
......000.
.0....000.
...0..000.
...0..000.
..........
......0...
....0.....
......0...
.0........
...0......
